10
2 0 0 0 0 0 0 0 0 2
2 0 0 0 0 0 0 0 0 2
2 0 0 0 0 0 0 0 0 2
2 0 0 0 0 0 0 0 0 2
2 0 0 0 0 0 0 0 0 2
2 0 0 0 2 0 0 0 0 2
2 0 0 0 1 1 1 1 1 2
2 0 0 0 0 0 0 0 0 2
2 0 0 0 0 1 1 1 0 2
1 1 1 1 1 1 1 1 1 1 
30 5 1
0 7 4
0 7 2 
