10
2 2 2 2 2 2 2 2 2 2
2 0 0 0 0 0 0 0 0 2
2 0 0 0 0 0 0 0 0 2
2 0 0 0 0 0 5 0 0 2
2 0 0 0 0 0 0 0 0 2
2 0 0 0 2 0 0 0 0 2
2 0 0 2 1 1 1 1 1 2
2 2 0 0 0 0 0 0 0 2
2 0 0 0 0 1 1 1 0 2
1 1 1 1 1 1 1 1 1 1 
30 2 1
0 7 4
0 7 2 
0 6 7
1 2 4
2 2 5
1 2 6
