100 10
0 0 0 0 0 0 0 0 0 0 0 0 0 0 0 0 0 0 0 0 0 0 0 0 0 0 0 0 0 0 0 0 0 0 0 0 0 0 0 0 0 0 0 0 0 0 0 7 7 0 0 0 0 0 0 0 0 0 0 0 0 0 0 0 0 0 0 0 0 0 0 0 0 0 0 0 0 0 0 0 0 0 0 0 0 0 0 0 0 0 0 0 0 0 0 0 0 0 0 9 
0 0 0 0 0 0 7 7 0 0 0 0 0 0 0 0 0 0 0 0 0 0 0 0 0 0 0 0 0 0 0 0 0 0 0 0 0 0 0 0 0 0 0 0 0 0 0 8 0 0 0 0 0 0 0 0 0 0 0 0 0 0 9 0 0 9 0 0 0 0 0 0 0 0 0 0 0 0 0 0 0 0 0 0 0 7 7 7 7 7 7 7 0 0 0 0 0 0 0 9 
0 0 0 0 0 7 8 8 7 0 9 0 0 7 7 7 7 7 7 7 7 7 7 7 0 0 0 0 0 0 0 0 0 7 7 7 7 7 7 7 0 0 0 0 0 0 0 8 0 9 0 9 0 9 0 9 0 0 0 0 0 0 0 0 0 0 0 0 0 0 0 0 9 0 0 0 9 0 0 0 0 0 9 0 0 8 8 8 8 8 8 8 0 0 0 0 0 0 0 9 
0 0 0 0 0 8 8 8 8 0 0 0 0 0 0 0 0 0 0 0 0 0 0 0 0 7 0 0 0 0 0 7 7 8 8 8 8 8 8 8 7 7 7 0 0 0 0 0 0 0 0 0 0 0 0 0 0 9 0 0 9 0 0 0 0 0 0 0 0 9 0 0 0 0 0 0 0 0 0 0 0 0 0 0 0 8 8 8 8 8 8 8 0 0 0 0 0 0 0 9 
0 7 7 0 0 8 0 0 8 0 0 9 0 7 7 7 7 0 0 0 0 0 0 7 0 0 0 7 0 0 7 8 8 8 8 8 8 8 8 8 8 8 8 7 0 0 0 0 0 0 0 0 0 0 0 0 0 0 0 0 0 0 0 0 0 0 0 0 0 0 0 0 0 0 0 0 0 0 0 0 0 0 0 0 0 8 8 8 8 8 8 8 0 0 0 0 0 0 0 9 
0 8 8 0 0 0 0 0 0 0 0 0 0 8 8 8 8 0 0 0 0 0 0 8 0 0 0 0 0 7 8 8 8 0 0 0 0 0 0 0 0 8 8 8 7 0 0 0 0 0 7 0 7 0 7 0 0 0 0 0 0 0 0 0 0 0 0 0 0 0 0 0 0 0 0 0 0 0 0 0 0 0 0 0 0 8 8 8 8 8 8 8 0 0 0 0 0 0 7 9 
0 0 0 0 0 0 7 7 0 0 9 0 0 0 0 0 0 0 0 0 0 0 0 0 0 0 0 0 7 8 8 8 8 0 7 7 7 7 7 7 0 8 8 8 8 7 7 0 0 0 8 0 8 0 8 0 0 0 0 0 0 0 0 0 0 0 0 0 0 0 0 0 0 0 0 0 0 0 0 0 0 0 0 9 0 8 8 8 8 8 8 8 0 0 0 7 0 0 0 9 
0 0 0 0 0 7 8 8 7 0 0 0 0 7 7 7 7 0 0 0 0 0 0 0 0 0 0 0 0 0 0 0 0 0 0 0 0 0 0 0 0 0 0 0 0 0 0 0 7 0 0 0 0 0 0 0 7 0 0 0 7 0 0 0 0 0 7 0 0 0 0 7 0 0 0 0 0 7 0 0 0 0 9 8 9 8 8 8 8 8 8 8 0 0 7 8 7 0 0 9 
7 7 7 7 7 8 8 8 8 0 0 0 0 8 8 8 8 7 7 7 7 7 7 7 7 7 7 7 7 7 7 7 7 7 7 7 7 7 7 7 7 7 7 7 7 7 7 7 8 0 0 0 0 0 0 0 8 7 7 7 8 0 0 0 0 0 8 7 7 7 7 8 0 0 0 0 0 8 7 7 7 7 7 7 7 8 8 8 8 8 8 8 7 7 8 8 8 7 7 7 
8 8 8 8 8 8 8 8 8 8 8 8 8 8 8 8 8 8 8 8 8 8 8 8 8 8 8 8 8 8 8 8 8 8 8 8 8 8 8 8 8 8 8 8 8 8 8 8 8 8 8 8 8 8 8 8 8 8 8 8 8 8 8 8 8 8 8 8 8 8 8 8 8 8 8 8 8 8 8 8 8 8 8 8 8 8 8 8 8 8 8 8 8 8 8 8 8 8 8 8 
21 98 4
30 1 3
0 1 7
0 3 7
0 6 0
0 7 0
0 6 5
0 7 5
0 5 1
0 8 1
3 10 1
2 21 6
0 16 1
0 15 1
0 20 1
0 21 1
0 22 1
0 29 4
0 31 2
0 32 2
0 33 1
0 34 1
0 35 1
0 36 1
0 38 1
0 39 1
0 42 2
0 41 2
0 44 4
0 46 5
0 45 5
0 34 5
0 35 5
0 37 5
0 38 5
0 25 7
0 26 7
0 28 7
0 33 7
0 37 7
0 39 7
0 40 7
0 45 7
0 42 7
0 47 7
0 38 7
0 36 7
0 35 7
0 34 7
0 32 7
0 41 7
0 43 7
0 44 7
0 46 7
0 23 7
0 24 7
0 27 7
0 29 7
0 30 7
0 31 7
3 23 3
3 51 1
3 53 1
3 62 0
3 69 2
3 76 1
4 74 4
4 21 5
5 50 8
5 49 8
5 51 8
5 52 8
5 53 8
5 54 8
5 55 8
5 61 8
5 62 8
5 63 8
5 64 8
5 65 8
5 72 8
5 73 8
5 74 8
5 75 8
5 76 8
5 9 8
5 10 8
5 11 8
5 12 8
20 28 2
20 63 4
20 80 7
21 83 5
20 52 4
20 40 5
20 64 4
20 74 5
20 75 5
20 92 1
20 92 2
20 92 3
20 92 4
20 92 5
20 92 6
20 92 7
