100
0 0 0 0 0 0 0 0 0 0 0 0 0 0 0 0 0 0 0 0 0 0 0 0 0 0 0 0 0 0 0 0 0 1 1 1 1 1 1 1 1 1 1 1 1 1 1 1 0 0 0 0 0 0 0 0 0 1 1 1 1 1 1 1 1 1 1 1 1 1 1 1 0 0 0 9 9 9 9 9 9 9 9 9 9 0 0 0 0 0 0 0 0 0 0 0 0 0 0 9 
0 0 7 0 0 0 0 0 0 0 0 0 0 0 0 0 0 1 1 1 1 1 1 1 1 1 1 1 1 1 0 0 0 0 0 0 0 0 0 0 0 0 0 0 0 0 0 0 1 0 0 0 0 0 0 0 0 1 0 0 0 0 0 0 0 0 0 0 0 0 0 1 0 0 9 0 0 0 0 0 0 0 0 0 0 0 7 7 7 7 0 7 0 0 0 0 0 0 0 9 
0 0 8 0 0 0 0 0 0 0 0 0 0 0 0 0 1 0 0 0 0 0 0 0 0 0 0 0 0 0 1 0 0 3 0 0 0 0 3 0 0 0 0 0 3 0 0 3 0 0 0 0 3 0 0 0 0 1 0 0 0 0 0 0 3 0 0 0 0 0 0 1 0 0 3 0 9 9 9 9 9 9 9 7 7 7 8 8 0 2 7 2 0 0 0 9 0 0 0 9 
0 0 8 0 0 0 0 0 0 0 0 0 0 0 0 0 1 0 0 0 0 0 0 0 0 0 0 0 0 0 1 0 0 1 0 0 0 0 0 0 0 0 0 0 0 0 0 1 0 0 0 0 0 0 0 0 0 1 0 0 0 0 0 0 0 0 0 0 0 0 0 1 0 0 3 0 0 0 0 0 0 0 3 8 8 0 2 0 0 2 0 2 0 0 0 0 0 0 0 9 
0 0 8 0 0 0 0 0 0 0 0 0 0 0 0 0 1 0 0 0 0 0 0 0 0 0 0 0 0 0 1 0 0 1 0 0 0 0 0 0 0 0 0 0 0 0 0 1 0 0 0 0 0 0 0 0 0 1 0 0 0 0 3 0 0 0 3 0 0 0 0 1 0 0 3 9 9 9 9 9 9 0 3 2 0 0 2 0 0 0 0 2 0 0 0 0 0 0 0 9 
0 0 9 0 0 0 0 0 0 0 0 0 0 0 0 0 0 0 0 0 0 0 0 0 0 0 0 0 0 0 0 0 0 1 0 0 3 0 0 0 0 0 0 0 0 0 0 1 0 0 0 0 0 0 0 0 0 1 0 0 0 0 0 0 0 0 0 0 0 0 0 1 0 0 3 0 0 0 0 0 0 0 3 2 0 0 0 0 0 0 0 2 0 0 0 0 0 0 0 9 
0 0 7 0 0 0 0 0 0 0 0 0 0 0 0 0 0 0 0 1 0 0 1 0 0 1 0 0 1 0 0 0 0 0 0 0 0 0 0 0 0 0 0 0 0 0 0 0 0 0 0 0 0 0 0 0 0 1 0 0 3 0 0 0 3 0 0 0 3 0 0 1 0 0 9 0 9 9 9 9 9 9 9 0 0 0 0 2 0 0 0 0 0 0 0 0 0 0 0 9 
0 0 7 0 0 0 0 0 0 0 0 0 0 0 0 0 1 0 0 0 0 0 0 0 0 0 0 0 0 0 1 0 0 0 0 0 0 0 0 0 0 0 0 0 0 0 0 0 7 0 0 0 0 0 0 0 0 0 0 0 0 0 0 0 0 0 0 0 0 0 0 0 0 0 0 0 0 0 0 0 0 0 0 0 0 0 0 3 0 0 0 0 0 0 0 7 0 0 0 9 
5 5 7 7 7 7 7 7 7 7 7 7 7 7 7 7 7 0 0 0 0 0 0 0 0 0 0 0 0 0 7 7 7 7 7 7 7 7 7 7 7 7 7 7 7 7 7 7 8 0 0 0 0 0 0 7 7 7 7 7 7 0 0 0 0 0 0 0 7 7 7 7 7 7 7 7 7 7 7 7 7 7 7 7 7 9 0 3 0 0 2 9 9 0 7 8 7 0 7 7 
4 4 8 8 8 8 8 8 8 8 8 8 8 8 8 8 8 8 8 8 8 8 8 8 8 8 8 8 8 8 8 8 8 8 8 8 8 8 8 8 8 8 8 8 8 8 8 8 8 8 8 8 8 8 8 8 8 8 8 8 8 8 8 8 8 8 8 8 8 8 8 8 8 8 8 8 8 8 8 8 8 8 8 8 8 8 0 3 0 0 2 8 8 8 8 8 8 8 8 8 
5 50 8
5 49 8
5 51 8
5 52 8
5 53 8
5 54 8
30 5 7
5 29 8
5 28 8
5 27 8
5 26 8
5 25 8
5 24 8
5 23 8
5 22 8
5 21 8
5 20 8
5 19 8
5 18 8
5 17 8
6 15 7
0 14 7
0 12 7
0 22 5
0 19 5
0 25 5
0 28 5
1 18 2
6 41 7
6 45 7
6 35 7
3 38 1
3 44 1
20 64 5
20 62 3
20 66 3
20 64 1
20 94 0
20 94 1
20 95 1
20 95 0
0 60 5
0 68 5
5 62 8
5 61 8
5 63 8
5 64 8
5 65 8
5 66 8
5 67 8
5 86 9
5 87 9
6 78 5
6 82 1
4 58 1
3 52 1
5 88 9
5 90 1
6 38 7
6 58 7
6 56 7
6 69 7
6 74 7
6 79 7
6 78 3
6 79 1
20 87 5
20 87 4
20 89 5
20 88 5
20 89 4
20 88 4
20 75 1
20 81 3
20 75 5
5 8 7
5 94 7
5 96 7
5 93 8
5 97 8
21 95 6
