100 10
0 0 0 0 0 0 0 0 0 0 0 0 0 0 0 6 6 5 4 4 4 4 4 4 4 4 4 4 4 4 4 5 6 6 6 0 0 0 0 0 0 0 0 0 0 0 0 0 0 0 0 0 0 0 0 0 0 0 0 0 0 0 0 0 0 0 0 0 0 0 0 0 0 0 0 0 0 0 0 0 0 0 0 0 0 0 0 0 0 0 0 0 0 0 0 0 0 5 5 5 
0 0 0 0 0 0 0 0 0 0 0 0 0 0 0 5 5 4 4 0 0 0 0 0 0 0 0 0 4 4 4 4 5 5 5 0 0 0 0 0 0 0 0 0 0 0 0 0 0 3 0 0 0 3 0 0 0 0 0 0 0 0 0 0 0 0 0 0 0 0 0 0 0 0 0 0 0 0 0 0 0 0 0 0 0 0 0 0 0 0 0 0 0 0 0 0 0 4 4 4 
0 0 0 0 0 0 0 0 0 0 0 0 0 6 5 4 4 4 4 0 0 0 0 0 0 0 0 0 0 0 0 4 4 4 4 6 0 0 0 0 0 0 0 3 0 0 0 3 0 3 0 0 0 3 0 0 1 1 1 1 1 1 1 1 1 1 1 1 0 0 1 1 1 1 1 1 1 1 1 0 0 0 0 0 0 0 0 0 0 0 0 0 0 0 0 0 0 4 4 4 
0 0 0 0 0 0 0 0 0 0 0 0 0 5 4 0 0 0 4 4 4 4 4 0 0 0 0 0 0 0 0 0 0 0 4 5 0 0 0 0 0 0 0 3 0 3 0 3 0 3 0 3 0 3 0 0 3 0 0 0 0 0 0 0 0 0 0 0 0 0 0 0 0 0 0 0 0 0 3 0 0 0 0 0 0 0 0 0 0 0 0 0 0 0 0 0 0 4 4 4 
0 0 0 0 0 0 0 0 0 0 0 0 0 4 4 0 0 0 0 0 0 0 0 0 0 4 0 0 4 0 0 0 0 0 4 4 0 0 0 0 0 3 0 3 0 3 0 3 0 3 0 3 0 3 0 0 0 0 0 0 0 0 0 0 0 0 0 0 0 0 0 0 0 0 0 0 0 0 0 0 0 0 0 0 0 0 0 0 0 0 0 0 0 3 3 0 0 4 4 4 
0 0 0 0 0 0 0 0 0 0 0 0 0 3 4 4 4 4 4 0 0 0 0 0 4 4 0 0 4 4 4 4 4 4 4 4 5 0 0 0 0 3 0 3 0 3 0 3 0 3 0 3 0 3 0 0 0 0 0 0 0 0 0 0 0 0 0 0 0 0 0 0 0 0 0 0 0 0 0 0 0 0 0 0 0 0 0 0 0 0 0 0 2 2 2 2 0 4 4 4 
0 0 0 0 0 0 0 0 0 0 0 0 0 3 4 4 4 0 0 0 4 4 4 4 4 4 0 0 4 4 4 4 4 4 4 4 3 0 0 0 0 3 0 3 0 3 0 3 0 3 0 3 0 3 0 0 0 0 0 0 0 0 0 0 0 0 0 0 0 6 0 0 0 0 0 0 0 0 0 0 6 0 0 0 0 0 6 6 0 0 0 3 3 3 3 3 3 4 4 4 
6 0 0 0 0 0 0 0 0 0 0 0 0 0 0 0 4 0 4 4 4 0 0 0 0 0 0 0 0 0 0 0 0 0 0 0 0 0 0 3 0 0 0 0 0 0 0 0 0 0 0 0 0 0 0 0 0 0 0 6 6 0 0 0 0 6 6 6 5 5 5 5 5 5 5 5 5 5 5 5 5 5 5 5 5 5 5 5 5 5 5 5 5 5 5 5 5 4 4 4 
5 5 5 5 5 5 5 5 5 5 5 5 5 4 4 0 0 0 0 0 0 0 4 4 4 4 4 4 4 4 4 0 0 0 0 0 4 2 2 2 2 2 2 2 2 2 2 2 2 2 2 2 2 5 5 5 5 5 5 5 5 5 5 5 5 5 5 5 4 4 4 4 4 4 4 4 4 4 4 4 4 4 4 4 4 4 4 4 4 4 4 4 4 4 4 4 4 4 4 4 
4 4 4 4 4 4 4 4 4 4 4 4 4 4 4 4 4 4 4 4 4 4 4 4 4 4 4 4 4 4 4 4 4 4 4 4 4 2 2 2 2 2 2 2 2 2 2 2 2 2 2 2 2 4 4 4 4 4 4 4 4 4 4 4 4 4 4 4 4 4 4 4 4 4 4 4 4 4 4 4 4 4 4 4 4 4 4 4 4 4 4 4 4 4 4 4 4 4 4 4 
0 43 7
0 14 7
0 17 8
0 22 7
0 35 8
0 30 4
0 31 4
0 26 2
1 17 3
0 22 1
0 19 2
1 31 3
3 43 1
3 47 1
3 53 0
1 37 5
3 49 0
0 58 1
0 59 1
0 60 1
0 61 1
0 63 1
0 65 1
0 67 1
0 71 1
0 76 1
0 77 1
1 65 3
1 57 3
0 62 7
0 63 7
0 56 7
0 53 7
20 74 1
30 3 2
0 11 2
0 12 2
0 20 1
0 21 1
0 23 4
0 24 5
0 25 6
0 31 5
99 32 5
99 33 5
2 33 1
0 42 2
0 43 2
0 45 2
0 48 2
0 71 3
0 72 3
0 73 3
0 74 3
0 75 3
0 62 2
0 67 3
0 45 7
0 49 9
0 58 8
0 61 8
0 64 8
0 76 8
0 78 8
0 74 8
0 72 8
0 70 8
0 84 3
0 85 3
99 72 9
98 73 10
98 74 10
98 75 10
99 76 9
98 60 9
98 61 10
98 62 10
98 63 9
99 69 4
21 94 6
