100
0 0 0 0 0 0 0 0 0 0 0 0 0 0 0 6 6 5 5 5 5 5 5 5 5 5 5 5 5 5 5 5 6 6 6 0 0 0 0 0 0 0 0 0 0 0 0 0 0 0 0 0 0 0 0 0 0 0 0 0 0 0 0 0 0 0 0 0 0 0 0 0 0 0 0 0 0 0 0 0 0 0 0 0 0 0 0 0 0 0 0 0 0 0 0 0 0 5 5 5 
0 0 0 0 0 0 0 0 0 0 0 0 0 0 0 5 5 4 4 0 0 0 0 0 0 0 0 0 4 4 4 4 5 5 5 0 0 0 0 0 0 0 0 0 0 0 0 0 0 3 0 0 0 3 0 0 0 0 0 0 0 0 0 0 0 0 0 0 0 0 0 0 0 0 0 0 0 0 0 0 0 0 0 0 0 0 0 0 0 0 0 0 0 0 0 0 0 4 4 4 
0 0 0 0 0 0 0 0 0 0 0 0 0 6 5 4 4 4 4 0 0 0 0 0 0 0 0 0 0 0 0 0 0 0 4 6 0 0 0 0 0 0 0 3 0 0 0 3 0 3 0 0 0 3 0 0 1 1 1 1 1 1 1 1 1 1 1 1 0 0 1 1 1 1 1 1 1 1 1 0 0 0 0 0 0 0 0 0 0 0 0 0 0 0 0 0 0 4 4 4 
0 0 0 0 0 0 0 0 0 0 0 0 0 5 4 0 0 0 4 4 4 4 4 0 0 0 0 0 0 0 0 0 0 0 4 5 0 0 0 0 0 0 0 3 0 3 0 3 0 3 0 3 0 3 0 0 3 0 0 0 0 0 0 0 0 0 0 0 0 0 0 0 0 0 0 0 0 0 3 0 0 0 0 0 0 0 0 0 0 0 0 0 0 0 0 0 0 4 4 4 
0 0 0 0 0 0 0 0 0 0 0 0 0 4 4 0 0 0 0 0 0 0 0 0 0 4 0 0 4 0 0 0 0 0 4 4 0 0 0 0 0 3 0 3 0 3 0 3 0 3 0 3 0 3 0 0 0 0 0 0 0 0 0 0 0 0 0 0 0 0 0 0 0 0 0 0 0 0 0 0 0 0 0 0 0 0 0 0 0 0 0 0 0 3 3 0 0 4 4 4 
0 0 0 0 0 0 0 0 0 0 0 0 0 3 4 4 4 4 4 0 0 0 0 0 4 4 0 0 4 4 4 4 4 4 4 4 5 0 0 0 0 3 0 3 0 3 0 3 0 3 0 3 0 3 0 0 0 0 0 0 0 0 0 0 0 0 0 0 0 0 0 0 0 0 0 0 0 0 0 0 0 0 0 0 0 0 0 0 0 0 0 0 2 2 2 2 0 4 4 4 
0 0 0 0 0 0 0 0 0 0 0 0 0 3 4 4 4 0 0 0 4 4 4 4 4 4 0 0 4 4 4 4 4 4 4 4 3 0 0 0 0 3 0 3 0 3 0 3 0 3 0 3 0 3 0 0 0 0 0 0 0 0 0 0 0 0 0 0 0 6 0 0 0 0 0 0 0 0 0 0 6 0 0 0 0 0 6 6 0 0 0 3 3 3 3 3 3 4 4 4 
6 0 0 0 0 0 0 0 0 0 0 0 0 0 0 0 4 0 4 4 4 0 0 0 0 0 0 0 0 0 0 0 0 0 0 0 0 0 0 3 0 0 0 0 0 0 0 0 0 0 0 0 0 0 0 0 0 0 0 6 6 0 0 0 0 6 6 6 5 5 5 5 5 5 5 5 5 5 5 5 5 5 5 5 5 5 5 5 5 5 5 5 5 5 5 5 5 4 4 4 
5 5 5 5 5 5 5 5 5 5 5 5 5 4 4 0 0 0 0 0 0 0 4 4 4 4 4 4 4 4 4 0 0 0 0 0 4 2 2 2 2 2 2 2 2 2 2 2 2 2 2 2 2 5 5 5 5 5 5 5 5 5 5 5 5 5 5 5 4 4 4 4 4 4 4 4 4 4 4 4 4 4 4 4 4 4 4 4 4 4 4 4 4 4 4 4 4 4 4 4 
4 4 4 4 4 4 4 4 4 4 4 4 4 4 4 4 4 4 4 4 4 4 4 4 4 4 4 4 4 4 4 4 4 4 4 4 4 2 2 2 2 2 2 2 2 2 2 2 2 2 2 2 2 4 4 4 4 4 4 4 4 4 4 4 4 4 4 4 4 4 4 4 4 4 4 4 4 4 4 4 4 4 4 4 4 4 4 4 4 4 4 4 4 4 4 4 4 4 4 4 
0 43 7
0 46 7
0 11 7
0 14 7
0 12 7
0 17 8
0 21 8
0 20 8
0 24 7
0 25 7
0 23 7
0 22 7
0 30 7
0 34 8
0 35 8
0 30 4
0 31 4
0 33 4
0 24 4
0 26 2
1 17 3
0 22 1
0 19 2
20 20 1
1 31 3
3 43 1
3 47 1
3 53 0
1 37 5
3 49 0
0 58 1
0 59 1
0 60 1
0 61 1
0 63 1
0 65 1
0 67 1
0 71 1
0 76 1
0 77 1
1 74 3
1 65 3
1 57 3
0 67 6
0 62 7
0 63 7
0 56 7
0 49 7
0 51 7
0 53 7
0 71 6
0 72 6
0 73 6
0 74 6
0 75 6
0 84 6
0 85 6
21 94 3
20 74 1
30 3 7
0 22 5
