100 10
0 0 0 0 0 1 1 1 1 1 1 1 1 1 1 1 1 1 1 0 0 0 0 0 0 0 0 0 0 0 0 0 0 0 0 0 0 0 0 0 0 0 0 0 0 0 0 0 0 0 0 0 0 0 0 0 0 0 0 0 0 0 0 0 0 0 0 0 0 0 0 0 0 0 0 0 0 0 0 0 0 0 0 0 0 0 0 0 0 0 0 0 0 0 0 0 0 0 0 2 
0 0 0 0 0 1 1 0 0 0 0 0 0 0 0 0 0 1 1 0 0 0 0 0 0 0 0 0 0 0 0 0 0 0 0 0 0 0 0 0 0 0 0 0 0 0 0 0 0 0 0 0 0 0 0 0 0 0 0 0 0 0 0 0 3 3 0 0 0 0 0 0 0 0 0 0 0 0 0 0 0 0 0 0 0 0 0 0 3 0 0 0 3 0 0 0 3 0 0 2 
0 0 0 0 0 1 1 0 0 0 0 0 0 0 0 0 0 1 1 0 0 0 0 0 0 0 0 0 0 0 0 0 0 0 0 0 0 0 0 0 0 0 0 0 0 3 3 3 3 3 0 0 0 0 0 0 0 0 0 0 0 3 3 0 1 1 0 3 1 3 0 0 3 1 1 1 3 0 0 3 3 0 0 0 0 0 0 0 0 0 0 0 0 0 0 0 0 0 0 2 
0 0 0 0 0 1 1 0 0 0 0 0 0 0 0 0 0 0 0 0 0 0 0 0 0 0 0 0 0 0 0 0 0 0 0 0 0 0 0 0 0 0 0 0 3 0 0 0 0 0 3 0 0 0 0 0 0 0 3 3 0 0 0 0 1 1 0 0 0 0 0 0 0 0 0 0 0 0 3 0 0 0 0 0 0 0 3 0 0 0 3 0 0 0 3 0 0 0 3 2 
0 0 0 0 0 1 1 0 0 0 0 0 0 0 0 0 0 0 0 0 0 0 0 0 0 0 0 0 0 0 0 0 0 0 0 0 0 0 0 0 0 0 3 0 2 0 0 0 0 0 2 0 0 0 3 1 3 0 0 0 0 0 0 0 3 3 0 0 0 1 1 0 1 1 1 1 1 1 0 0 3 0 1 1 0 0 0 0 0 0 0 0 0 0 0 0 0 0 0 2 
0 0 0 0 0 1 1 0 0 0 0 0 0 0 0 0 0 0 0 0 0 0 0 0 0 0 0 1 1 1 0 0 1 1 1 0 0 0 1 1 3 0 0 0 2 0 0 0 0 0 2 1 0 0 0 0 0 0 0 0 0 0 0 0 0 0 0 0 1 1 1 0 1 1 1 0 0 0 0 1 1 0 2 0 1 0 0 0 0 0 0 0 0 0 0 0 3 0 0 2 
3 0 0 0 0 1 1 0 0 0 0 0 0 0 0 0 0 2 0 0 1 1 0 0 1 1 0 0 2 0 0 0 0 2 0 0 0 0 0 0 3 0 0 0 0 0 0 0 0 0 0 0 0 1 0 0 0 0 0 0 0 0 0 0 0 0 0 1 1 1 1 0 1 2 0 0 0 1 1 0 2 0 2 0 0 0 0 0 0 0 0 0 0 0 0 0 0 0 0 2 
1 0 0 0 0 2 2 0 0 0 0 0 0 0 2 0 2 1 0 0 0 2 0 0 0 2 0 0 2 0 0 0 0 2 0 0 0 0 0 0 3 0 0 0 1 1 1 1 1 1 1 1 1 0 0 0 0 0 0 0 0 0 0 0 1 1 1 1 1 1 2 0 2 0 0 0 2 0 0 0 2 0 2 0 0 0 0 0 0 0 1 1 1 1 1 1 1 1 1 2 
1 0 0 0 0 0 0 0 0 0 0 0 2 0 2 0 0 0 0 0 0 2 0 0 0 2 3 0 0 0 0 0 0 0 0 0 0 0 0 0 0 0 3 0 0 0 0 0 0 0 0 0 0 0 0 3 0 0 0 0 0 0 0 2 1 1 1 1 1 1 2 0 0 0 0 0 2 0 0 0 0 0 0 0 0 0 0 0 0 0 2 0 0 0 2 0 0 0 2 2 
1 1 1 1 1 1 1 1 1 1 1 1 1 1 1 1 1 1 1 1 1 1 1 1 1 1 1 1 1 1 1 1 1 1 1 1 1 1 1 1 1 1 1 1 1 1 1 1 1 1 1 1 1 1 1 1 1 1 1 1 1 1 1 1 1 1 1 1 1 1 1 1 1 1 1 1 1 1 1 1 1 1 1 1 1 1 1 1 1 1 1 1 1 1 1 1 1 1 1 1 
1 7 1
1 8 2
1 45 3
1 47 3
0 12 7
0 14 6
0 20 8
0 22 8
0 23 8
0 24 8
0 27 8
0 28 8
0 44 8
0 46 8
0 48 8
0 50 8
0 52 8
0 46 6
0 47 6
0 48 6
0 49 6
0 56 3
0 21 5
0 25 5
0 27 4
0 29 4
0 33 4
0 32 4
0 42 3
0 46 1
0 48 1
0 44 2
0 54 3
0 39 4
0 34 8
0 35 8
0 40 8
0 41 8
0 26 7
0 17 5
1 14 1
1 15 2
0 59 2
0 61 1
0 67 1
0 69 1
0 73 1
0 76 1
0 75 1
0 79 1
1 66 3
1 77 3
1 78 7
1 74 6
1 75 5
1 88 3
1 92 3
1 96 3
0 78 8
0 82 8
0 85 8
0 84 4
0 89 6
0 91 6
0 97 6
0 82 3
4 12 3
4 60 7
4 31 7
21 98 2
20 94 2
20 72 8
20 47 1
20 31 6
30 2 8
