100 10
0 0 0 0 0 0 0 0 0 0 0 0 0 0 0 0 0 0 0 0 0 0 0 0 0 0 0 0 0 0 0 0 0 0 0 0 0 0 0 0 0 0 0 0 0 0 0 0 0 0 0 0 0 0 0 0 0 0 0 0 0 0 0 0 0 0 0 0 0 0 0 0 0 0 0 0 0 0 0 0 0 0 0 0 0 0 0 0 0 0 0 0 0 0 0 0 0 0 0 0 
0 0 0 0 0 0 0 0 0 0 0 0 0 0 0 0 0 0 0 0 0 3 0 0 0 0 0 0 0 0 0 0 0 0 0 0 0 0 0 0 0 0 0 0 0 0 0 0 0 0 0 0 0 0 0 0 0 0 0 3 0 0 0 0 0 0 0 0 0 0 0 0 2 0 0 0 0 0 2 0 0 0 0 0 0 2 0 0 6 6 6 6 6 6 6 0 0 0 0 0 
0 0 0 0 0 0 0 0 0 0 0 0 0 0 0 0 3 0 0 0 0 0 0 0 0 0 0 0 0 0 0 0 0 1 3 1 1 3 1 0 0 1 3 1 1 3 1 0 0 0 0 0 0 0 0 0 0 0 0 0 0 0 0 0 0 0 0 3 0 0 0 0 0 0 0 2 0 0 0 0 0 0 2 0 0 0 0 0 6 5 5 5 5 5 5 0 9 0 0 0 
0 0 0 0 0 0 0 0 0 0 0 0 0 0 0 0 0 0 0 0 0 0 0 0 0 0 0 0 0 0 0 0 0 0 2 0 0 2 0 0 0 0 0 0 0 0 0 0 0 0 0 0 0 0 0 0 0 0 0 0 0 0 0 0 0 0 0 3 0 0 0 0 0 0 0 0 0 0 0 0 0 0 0 0 0 0 0 0 6 4 4 4 4 4 4 0 0 0 0 0 
0 2 0 0 0 0 0 0 0 0 0 0 0 0 0 0 0 0 0 0 0 0 0 0 0 0 0 0 0 0 1 1 0 0 0 0 0 0 0 0 0 0 0 0 0 0 0 0 1 1 0 0 0 1 1 1 1 1 0 3 0 1 1 1 1 1 0 3 0 0 3 0 0 0 0 0 0 0 0 0 0 0 0 0 0 0 0 0 6 4 4 4 4 4 4 0 0 0 9 0 
0 2 0 1 3 3 1 0 0 0 0 0 0 0 0 0 0 0 0 0 0 0 0 0 0 0 0 0 0 0 0 2 0 0 0 0 0 0 0 0 0 0 0 0 0 0 0 0 0 0 0 0 0 0 0 0 0 0 0 0 0 0 0 0 0 0 0 0 0 0 3 0 0 0 0 0 0 0 0 0 0 0 0 0 0 0 0 0 6 4 4 4 4 4 4 0 0 0 0 0 
0 2 0 2 0 0 2 0 0 0 1 1 3 1 1 0 0 0 0 0 0 2 0 0 0 0 0 1 1 0 0 2 0 1 1 0 0 0 0 0 0 0 0 0 6 0 0 0 0 0 0 0 0 0 0 0 0 0 0 0 0 0 0 0 0 0 0 0 0 0 0 0 0 0 0 0 0 0 0 0 0 0 0 0 0 0 1 3 6 4 4 4 4 4 4 0 0 0 0 0 
0 2 0 2 0 0 2 0 2 0 2 0 2 0 2 0 0 0 0 2 0 2 0 0 2 0 0 0 3 0 0 2 0 0 2 0 0 2 0 0 6 0 0 6 6 6 0 0 0 0 0 6 0 0 0 0 0 0 0 6 0 0 0 0 0 0 0 0 0 0 0 0 2 0 0 0 0 2 0 0 0 0 0 2 0 1 3 3 6 4 4 4 4 4 4 0 0 0 2 0 
0 2 0 5 5 5 5 0 2 0 5 5 5 5 5 0 2 0 0 2 0 2 0 0 2 0 0 0 0 0 0 2 0 0 2 0 0 2 5 5 5 5 5 5 5 5 5 5 5 0 0 5 5 5 5 5 5 5 5 5 0 0 2 0 0 0 1 1 1 5 5 5 5 5 5 5 5 5 5 5 5 5 5 5 5 5 5 5 5 4 4 4 4 4 4 5 5 7 7 7 
0 2 0 4 4 4 4 0 2 0 4 4 4 4 4 0 2 0 0 2 0 4 4 4 4 4 4 4 4 4 0 2 0 0 2 0 0 2 4 4 4 4 4 4 4 4 4 4 4 0 0 4 4 4 4 4 4 4 4 4 0 0 2 0 0 0 2 0 0 4 4 4 4 4 4 4 4 4 4 4 4 4 4 4 4 4 4 4 4 4 4 4 4 4 4 4 8 8 8 8 
0 10 5
0 12 5
5 23 8
5 27 8
5 26 8
5 28 8
5 29 8
20 8 6
5 0 9
5 2 9
5 7 9
5 9 9
5 22 8
5 25 8
5 15 9
5 17 9
5 18 9
5 20 9
0 5 4
6 35 1
6 38 1
6 44 1
6 46 1
0 31 3
0 34 5
0 27 5
1 43 4
1 35 4
5 30 9
5 32 9
0 38 7
0 42 7
0 46 7
0 47 7
0 52 7
6 49 3
20 51 0
20 51 1
20 51 2
30 1 3
3 59 0
3 59 3
3 21 0
3 16 1
6 58 7
6 55 3
6 57 3
6 61 3
6 64 3
0 54 3
0 62 3
0 65 3
5 49 9
5 50 9
5 33 9
5 35 9
5 36 9
1 57 2
1 50 2
3 67 1
5 60 9
5 61 9
5 63 9
5 64 9
5 65 9
5 73 7
5 74 7
5 75 7
5 76 7
5 78 7
5 79 7
5 80 7
5 81 7
5 82 7
3 70 3
6 69 7
21 87 5
1 79 2
1 75 1
3 72 0
3 78 0
20 96 1
20 98 3
20 95 7
20 95 6
21 98 6
